29 33

11111111111111111111111111111
10000001000010000000010000101
11110110010110111101100101101
10000101010010100001010100101
10101000000010101010000000101
10001110111110100011101111101
11100010100010111000101000101
10011010101010100110101010101
10000000000010100000000000101
11110111111010111101111110101
10000010001010100000100010101
10101010101010101010101010101
10001010000010100010100000101
11111011111110111110111111101
10011010101010100110101010101
10000000000010100000000000101
11110111111010111101111110101
10000010001010100000100010101
10101010101010101010101010101
10001210000010100010100000101
11111110111110111111101111101
10000000100010100000001000101
10111110101010101111101010101
10000010100010100000101000101
11111010011110111110100111101
10000011000010100000110000101
10111110011010101111100110101
10100010111110101000101111101
10001010000010100010100000101
11111011111110111110111111101
10000000000010100000000000101
11101110111000101011101110001
11111111111111111111111111111